# ########
# #      #
# # ### ##
# # ### ##
# # #   ##
# # ### ##
# # #   ##
# # ### ##
#     ####
##### ####
S:1,0
G:5,9
T:8,1
T:5,4
T:5,6
T:7,7
8:1,7
6:7,3
